111111111111
1P000C000001
101110001001
1C000E000001
100C00010001
100010000101
101000010001
111111111111
