11111111111111111
1P000C00000100C01
10111000100100001
1C000E00100100C01
100C0001000100001
10001000010000E01
10100001000010001
11111111111111111
