1111111111111
10C00E0100001
100010C100001
1P00000000001
1000C0000001
1000000000001
1000C00000001
1111111111111