11111111
1P000C01
10111001
1C000E01
10000001
11111111
