111111111111
1P000C000011
101110000111
1C000E000011
100C00011111
111111111111
