11111111
10C00E01
100010C1
1P000001
1000C001
10000001
1000C001
11111111